QQQQQQQQQQQQQQQQQQ
QQQQQQQQQQQQQQQQQQ
QQQQQQQQQQQQQQQQQQ
QQQQQQQQQQQQQQQQQQ
QQQQQ00100000QQQQQ
QQQQQ00000000QQQQQ
QQQQQ00000000QQQQQ
QQQQQ00000100QQQQQ
QQQQQ00010000QQQQQ
QQQQQ0Z0Z0Z0ZQQQQQ
QQQQQ0000X000QQQQQ
QQQQQQQQQQQQQQQQQQ
QQQQQQQQQQQQQQQQQQ
QQQQQQQQQQQQQQQQQQ
QQQQQQQQQQQQQQQQQQ
