QQQQQQQQQQQQQQQQQQ0Q
QQQQQQQQQQQQQQQQQQQQ
QQQQQQQQQQQQQQQQQQQQ
QQQQQQQQQQQQQQQQQQQQ
QQQQQ00100000QQQQQQQ
QQQQQ0ZZ00ZZ0QQQQQQQ
QQQQQ0ZZ00ZZ0QQQQQQQ
QQQQQ00000000QQQQQQQ
QQQQQ0ZZZZZZ0QQQQQQQ
QQQQQ0ZZZZZZ0QQQQQQQ
QQQQQ0000X000QQQQQQQ
QQQQQQQQQQQQQQQQQQQQ
QQQQQQQQQQQQQQQQQQQQ
QQQQQQQQQQQQQQQQQQQQ
QQQQQQQQQQQQQQQQQQ0Q
