QQQQQQQQQQQQQQQQQQQQ
QQQQQQQQQQQQQQQQQQQQ
QQQQQQQQQQQQQQQQQQQQ
QQQQQQQQQQQQQQQQQQQQ
QQQQQ00100000QQQQQQQ
QQQQQ0Z0ZZ0Z0QQQQQQQ
QQQQQ00000000QQQQQQQ
QQQQQ0ZZZZZZ0QQQQQQQ
QQQQQ00000000QQQQQQ0
QQQQQ0ZZZZZZ0QQQQQQ0
QQQQQ0000X000QQQQQQQ
QQQQQQQQQQQQQQQQQQQQ
QQQQQQQQQQQQQQQQQQQQ
QQQQQQQQQQQQQQQQQQQQ
QQQQQQQQQQQQQQQQQQQQ
