QQQQQQQQQQQQQQQQQQQQ
QQQQQQQQQQQQQQQQQQQQ
QQQQQQQQQQQQQQQQQQQQ
QQQQQQQQQQQQQQQQQQQQ
QQQQQ10000001QQQQQQQ
QQQQQ0Z0ZZZZ0QQQQQQQ
QQQQQ00000000QQQQQQQ
QQQQQ0ZZ000Z0QQQQQQQ
QQQQQ0ZZZ0ZZ0QQQQQQQ
QQQQQ0Z0000Z0QQQQQQQ
QQQQQ0Z00X0Z0QQQQQQQ
QQQQQQQQQQQQQQQQQQQQ
QQQQQQQQQQQQQQQQQQQQ
QQQQQQQQQQQQQQQQQQQQ
QQQQQQQQQQQQQQQQQQQQ
