QQQQQQQQQQQQQQQQQQQQ
QQQQQQQQQQQQQQQQQQQQ
QQQQ0010001000QQQQQQ
QQQQ0000000000QQQQQQ
QQQQ0ZZZZZZZZ0QQQQQQ
QQQQ0000000000QQQQQQ
QQQQ0ZZ0ZZ0ZZ0QQQQQQ
QQQQ0ZZ0ZZ0ZZ0QQQQQQ
QQQQ0000000000QQQQQQ
QQQQ00ZZZZZZ00QQQQQQ
QQQQ00Z00X0Z00QQQQQQ
QQQQ00Z0000Z00QQQQQQ
QQQQ0000000000QQQQQQ
QQQQQQQQQQQQQQQQQQQQ
QQQQQQQQQQQQQQQQQQQQ
