QQQQQQQQQQQQQQQQQQQQ
QQQQQQQQQQQQQQQQQQQQ
QQQQZZ100010ZZQQQQQQ
QQQQ0200000000QQQQQQ
QQQQ0ZZ0ZZ0ZZ0QQQQQQ
QQQQ0000000000QQQQQQ
QQQQ0ZZ0ZZ0ZZ0QQQQQQ
QQQQ0000000000QQQQQQ
QQQQ0Z0ZZZZ0Z0QQQQQQ
QQQQ0Z0ZZZZ0Z0QQQQQQ
QQQQ0ZZ00X0ZZ0QQQQQQ
QQQQ0ZZ0000ZZ0QQQQQQ
QQQQ0000000000QQQQQQ
QQQQQQQQQQQQQQQQQQQQ
QQQQQQQQQQQQQQQQQQQQ
