QQQQQQQQQQQQQQQQQQQQ
QQQQQQQQQQQQQQQQQQQQ
QQQZ0010001000ZQQQQQ
QQQZ0200000000ZQQQQQ
QQQZ0ZZ0ZZ0ZZ0ZQQQQQ
QQQZ0000ZZ0000ZQQQQQ
QQQ00ZZ0ZZ0ZZ00QQQQQ
QQQZ0000000000ZQQQQQ
QQQZ0ZZ0ZZ0ZZ0ZQQQQQ
QQQZ0ZZ0ZZ0ZZ0ZQQQQQ
QQQZ0Z000X00Z0ZQQQQQ
QQQZ0000000000ZQQQQQ
QQQZ0ZZZZZZZZ0ZQQQQQ
QQQQQQQQQQQQQQQQQQQQ
QQQQQQQQQQQQQQQQQQQQ
