11110000000000000000
0Z0Z0ZZZ0ZZ0Z0Z0ZZZ0
0ZZ00Z0Z0Z00ZZZ0Z0Z0
0Z0Z0Z0Z0Z00Z0Z0ZZZ0
0Z0Z0ZZZ0ZZ0Z0Z0Z0Z0
00000000000000000000
00Z000Z0000000000000
00ZZ0ZZ0ZZ0Z0ZZZ0Z00
00Z0Z0Z0Z00Z0Z000Z00
00Z000Z0Z00Z0ZZ00Z00
00000000Z00Z0Z000Z00
00Z0Z000ZZ0Z0ZZZ0000
000000000000000Z0Z00
0Z000Z000X0000000000
00ZZZ000000000000000
